000000000000000000000000000000000000000000000000
000000000000000000000000000000000000000000000000
000000000000000000000000000000000000000000000000
000000000000000000000000000011111100000000000000
000000000000000000000000000000000000000000000000
000000000000000000000000000000000000000000000000
000000000000000000111111000000000000000000000000
000000000000000000000000000000000000000000000000
000000000000000000000000000000000001111111111100
000000000000111110000000000000000000000000000000
000000000000000000000000011111000000000000000000
000000000000000000000000000000000000000000000111
000001110000000000011110000000011111111110000000
000000000000000000000000000000000000000000000000
000000000011111000000000000000000000000000000000
000000000000000000000111110000000000000000001111
011100000000000000000000000000000000000000000000
000000000000000000000000000011111000000000000000
000000000000000000001111100000000000001111100000
001111110000000000000000000000000000000000000000
000000000000000111110000000000111110000000000000
000000000000000000000000000000000000000000000000
000000000000000000000000111110000000000000000000
000011111111000000000000000000000000111110000000
000000000000000000000000000000000000000000000000
000000000000000000001111100000000000000000000000
000011100000011100000000000000001111100000000000
000000000000000000000000000000000000000000000000
000000000000000011110000000000000000000000000000
111111111111111111111111111111111111111111111111
